TileSize: 32.0f
Rows: 50.0f
Colunms: 75.0f
111111111111111111111111111111111111111111111111111111111111111111111111111
100000000000000000000000000000000000000232300000000000232300000000000232301
100000000000000000000000000000000000000454500000000000454500000000000454501
100000000000000000000000000000000000000230000000000000230000000000000230001
100000000000000000000000000000000000000450000000000000450000000000000450001
100000000000000000000000000000000000000000000000000000000000000000000000001
500000000000000000001110000000000000000000000000000000000000000000000000001
550000000000000000000000000000000000000000000000000000000000000000000000001
105550000000000000011000000055000000000000000000000000000000000000000000001
100005555505505505505-150000005002300000000000000000000000000000000000000001
1000055505000000000-1-1-1-1-1555555004500000000000000000000000000000000000000001
105550000055500000-1000-10230055500000000232300000000000000000000000000232301
10500000000005023-1-10001-1450015500000000454500000000000000000000000000454501
10550000000000545-1000011100555500000000230000000000000000000000000000230001
10005000000000550-1000050555500500000000450000000000000000000000000000450001
10000555000-100055555-155-1-100005000000000000000000000000000000002300000000001
10000005550500000000-1000555550000000000000000000000000000000004500000000001
100000000000550505555555000000000000000000000000000000000000000000000000001
100000000000000000000000000000000000000000000000000000000000000000000000001
100000000000000000000000000000000000000000000000000000000000000001111111111
100000000000000000000000000000000000000000000000000000000000111111111111111
100000000023230000000000023230000000000023230000000000023230110000000023231
100000000045450000000000045450000000000045450000000000045450110000000045451
100000000023000000000000023000000000000023000000000000023000110000000023001
100000000045000000000000045000000000000045000000000000045000000000000045000
100000000000000000000000000000000000000000000000000000000000000000000000000
100000000000000000000000000000000000000000000000000000000000000000000000000
100000000000000000000000000000000000000000000000000000000000000000000000000
100000000000000000000000000000000000000000000000000000000000000000000000000
100000000000000000000000000000000000000000000000000000000000000000000000001
100000000000000000000000000000000000000000000000000000000000000000000000011
100000000023230000000000023230000000000023230000000000023230000000000023231
100000000045450000000000045450000000000045450000000000045450000000000045451
100000000023000000000000023000000000000023000000000000023000000000000023001
100000000045000000000000045000000000000045000000000000045000000000000045001
100000000000000000000000000000000000000000000000000000000000000000000000001
100000000000000000000000000000000000000000000000000000000000000000000000001
100000000000000000000000000000000000000000000000000000000000000000000000001
100000000000000000000000000000000000000000000000000000000000000000000000001
100000000000000000000000000000000000000000000000000000000000000000000000001
100000000000000000000000000000011111111111111111111111111110000000000000001
100000000023230000000000023230110000000023230100000000023230000000000023231
100000000045450000000000045450110000000045450100000000045450000000000045451
100000000023000000000000023000110000000023000100000000023000000000000023001
100000000045000000000000045000110000000045000100000000045000000000000045001
100000000000000000000000000000110000000000000100000000000000000000000000001
100000000000000000000100000000110000000000000000000000000000000000000000001
100000000000000000000000000100110000000000000000000000000000000000000000001
100000000000000000000000000000110000000000000000000000000000000000000000001
111111111111111111111111111111111111111111111111111111111111111111111111111
