TileSize: 32.0
Rows: 50
Columns: 75
111111111111111111111111111111111111111111111111111111111111111111111111111
100000000232301100000000232301100000000232301100000000232301100000000232301
101000000454501101000000454501101000000454501101000000454501101000000454501
100000000230001100000000230001100000000230001100000000230001100000000230001
100000000450001100000000450001100000000450001100000000450001100000000450001
100000000000001100000000000001100000000000001100000000000001100000000000001
100001000000001100001000000001100001000000001100001000000001100001000000001
100000000001001100000000001001100000000001001100000000001001100000000001001
100000000000001100000000000001100000000000001100000000000001100000000000001
111111111111111111111111111111111111111111111111111111111111111111111111111
111111111111111111111111111111111111111111111111111111111111111111111111111
100000000232301100000000232301100000000232301100000000232301100000000232301
101000000454501101000000454501101000000454501101000000454501101000000454501
100000000230001100000000230001100000000230001100000000230001100000000230001
100000000450001100000000450001100000000450001100000000450001100000000450001
100000000000001100000000000001100000000000001100000000000001100000000000001
100001000000001100001000000001100001000000001100001000000001100001000000001
100000000001001100000000001001100000000001001100000000001001100000000001001
100000000000001100000000000001100000000000001100000000000001100000000000001
111111111111111111111111111111111111111111111111111111111111111111111111111
111111111111111111111111111111111111111111111111111111111111111111111111111
100000000232301100000000232301100000000232301100000000232301100000000232301
101000000454501101000000454501101000000454501101000000454501101000000454501
100000000230001100000000230001100000000230001100000000230001100000000230001
100000000450001100000000450001100000000450001100000000450001100000000450001
100000000000001100000000000001100000000000001100000000000001100000000000001
100001000000001100001000000001100001000000001100001000000001100001000000001
100000000001001100000000001001100000000001001100000000001001100000000001001
100000000000001100000000000001100000000000001100000000000001100000000000001
111111111111111111111111111111111111111111111111111111111111111111111111111
111111111111111111111111111111111111111111111111111111111111111111111111111
100000000232301100000000232301100000000232301100000000232301100000000232301
101000000454501101000000454501101000000454501101000000454501101000000454501
100000000230001100000000230001100000000230001100000000230001100000000230001
100000000450001100000000450001100000000450001100000000450001100000000450001
100000000000001100000000000001100000000000001100000000000001100000000000001
100001000000001100001000000001100001000000001100001000000001100001000000001
100000000001001100000000001001100000000001001100000000001001100000000001001
100000000000001100000000000001100000000000001100000000000001100000000000001
111111111111111111111111111111111111111111111111111111111111111111111111111
111111111111111111111111111111111111111111111111111111111111111111111111111
100000000232301100000000232301100000000232301100000000232301100000000232301
101000000454501101000000454501101000000454501101000000454501101000000454501
100000000230001100000000230001100000000230001100000000230001100000000230001
100000000450001100000000450001100000000450001100000000450001100000000450001
100000000000001100000000000001100000000000001100000000000001100000000000001
100001000000001100001000000001100001000000001100001000000001100001000000001
100000000001001100000000001001100000000001001100000000001001100000000001001
100000000000001100000000000001100000000000001100000000000001100000000000001
111111111111111111111111111111111111111111111111111111111111111111111111111


